8	3	4	2	3	7	6
8	3	7	9	5	2	5
8	6	5	2	4	8	S
3	6	8	5	2	4	2
4	5	7	8	1	G	8
9	1	4	8	2	6	7
6	6	4	2	7	3	7
