4	4	8	6	1	6	3	1	8	3	1
5	4	8	2	5	3	8	3	6	3	2
6	9	6	2	5	6	1	2	8	9	3
3	8	7	3	8	8	3	2	2	2	9
9	5	4	7	2	5	9	8	2	7	9
5	3	8	4	G	7	7	9	5	3	8
3	S	4	1	8	8	8	8	1	2	1
3	2	5	8	2	1	2	8	7	3	8
5	8	9	4	6	9	6	5	8	3	2
4	5	1	9	6	9	4	8	4	9	3
9	5	5	4	2	1	9	5	3	8	9
