5	5	8	1	9	1	4	4	4	5	6	1	6	9	5
6	5	3	8	7	S	4	7	2	9	7	6	8	2	3
6	6	4	7	5	5	6	6	2	2	4	4	8	4	9
5	1	8	4	5	6	5	9	9	8	2	8	2	6	6
7	8	4	6	5	2	8	4	7	2	8	2	6	4	9
6	2	5	8	8	8	4	8	7	5	7	2	7	5	8
3	4	8	8	8	5	9	2	9	7	2	3	5	1	4
4	1	2	9	5	2	9	4	8	9	6	8	9	1	5
4	7	6	9	2	6	7	5	8	9	7	3	7	4	8
8	6	3	5	7	1	5	6	1	6	9	6	9	1	9
9	7	7	7	8	1	7	4	6	8	4	5	1	8	7
4	4	1	4	3	8	1	2	3	7	5	1	6	9	7
8	8	6	1	6	4	5	7	G	8	6	8	8	2	3
1	5	5	3	9	6	8	4	8	3	8	6	7	3	7
1	8	1	7	4	4	1	7	3	1	1	8	9	5	9
