4	6	9	8	3	4	9	6	2	6	3	3	2	7	3	5	6	4	9	5
9	6	9	2	3	8	1	2	3	9	9	5	5	4	7	7	8	6	2	7
6	1	1	6	7	7	9	2	6	1	3	2	2	5	4	5	7	2	1	6
5	1	4	7	9	9	6	7	S	6	1	2	4	1	8	7	2	2	2	4
8	3	1	4	8	6	4	5	7	4	1	6	2	4	8	4	1	1	8	1
1	3	4	1	3	3	8	4	1	6	5	5	4	1	4	3	8	4	6	5
9	3	2	2	7	6	2	6	8	6	7	1	2	7	9	2	2	9	8	6
7	2	1	6	7	5	1	7	8	8	2	3	3	8	2	9	6	8	3	8
7	9	2	1	9	5	7	7	6	8	3	1	3	3	5	3	3	2	7	1
3	1	7	9	9	6	5	7	4	2	1	9	9	8	1	9	2	9	3	3
4	6	1	6	7	2	3	5	3	2	7	9	4	1	2	2	3	4	2	4
4	6	7	2	5	8	3	5	1	1	1	9	6	8	2	1	8	8	5	1
9	1	5	4	1	5	4	5	2	7	5	5	8	8	6	4	9	9	2	2
3	7	6	3	7	3	6	2	3	5	2	6	5	4	G	2	7	3	9	1
4	6	5	2	5	7	3	3	1	8	5	7	5	5	5	1	8	6	5	9
5	7	4	4	7	2	7	9	1	9	9	3	5	8	4	8	7	2	1	2
4	8	8	8	9	4	1	4	5	4	2	8	3	9	3	2	7	3	7	9
1	9	5	5	2	6	2	3	1	3	1	7	1	1	9	3	8	9	9	2
2	4	2	9	9	9	9	7	9	5	4	9	8	7	2	3	5	3	3	9
1	4	9	8	2	4	6	2	9	2	3	9	8	8	1	9	7	3	8	2
